mymaze	0	259	120	260	65	1	2
0	4	4	-1	1	101	-1	0	-1
1	5	4	-1	2	-1	0	-1	-1
2	6	4	-1	3	-1	1	-1	-1
3	7	4	-1	4	-1	2	-1	-1
4	8	4	-1	5	-1	3	1	-1
5	9	4	-1	6	-1	4	-1	-1
6	10	4	-1	7	-1	5	-1	-1
7	11	4	-1	8	-1	6	-1	-1
8	12	4	-1	9	-1	7	2	-1
9	13	4	-1	10	-1	8	-1	-1
10	14	4	-1	11	-1	9	-1	-1
11	15	4	-1	12	-1	10	-1	-1
12	16	4	-1	13	-1	11	3	-1
13	17	4	-1	14	-1	12	-1	-1
14	18	4	-1	15	-1	13	-1	-1
15	19	4	-1	16	-1	14	-1	-1
16	20	4	-1	17	-1	15	4	-1
17	21	4	-1	18	-1	16	-1	-1
18	22	4	-1	19	-1	17	-1	-1
19	23	4	-1	20	-1	18	-1	-1
20	24	4	-1	21	-1	19	5	-1
21	25	4	-1	22	-1	20	-1	-1
22	26	4	-1	23	-1	21	-1	-1
23	27	4	-1	24	-1	22	-1	-1
24	28	4	-1	25	-1	23	6	-1
25	29	4	-1	26	-1	24	-1	-1
26	30	4	-1	27	-1	25	-1	-1
27	31	4	-1	28	-1	26	-1	-1
28	32	4	-1	29	-1	27	7	-1
29	33	4	-1	30	-1	28	-1	-1
30	34	4	-1	31	-1	29	-1	-1
31	35	4	-1	32	-1	30	-1	-1
32	36	4	-1	33	-1	31	8	-1
33	37	4	-1	34	-1	32	-1	-1
34	38	4	-1	35	-1	33	-1	-1
35	39	4	-1	36	-1	34	-1	-1
36	40	4	-1	37	-1	35	9	-1
37	41	4	-1	38	-1	36	-1	-1
38	42	4	-1	39	-1	37	-1	-1
39	43	4	-1	40	-1	38	-1	-1
40	44	4	-1	41	-1	39	10	-1
41	45	4	-1	42	-1	40	-1	-1
42	46	4	-1	43	-1	41	-1	-1
43	47	4	-1	44	-1	42	-1	-1
44	48	4	-1	45	-1	43	11	-1
45	49	4	-1	46	-1	44	-1	-1
46	50	4	-1	47	-1	45	-1	-1
47	51	4	-1	48	-1	46	-1	-1
48	52	4	-1	49	-1	47	12	-1
49	53	4	-1	50	-1	48	-1	-1
50	54	4	-1	51	240	49	-1	-1
51	55	4	-1	52	-1	50	-1	-1
52	56	4	-1	53	-1	51	13	-1
53	57	4	-1	54	-1	52	-1	-1
54	58	4	-1	55	-1	53	-1	-1
55	59	4	-1	56	-1	54	-1	-1
56	60	4	-1	57	-1	55	14	-1
57	61	4	-1	58	-1	56	-1	-1
58	62	4	-1	59	-1	57	-1	-1
59	63	4	-1	60	-1	58	-1	-1
60	64	4	-1	61	-1	59	15	-1
61	65	4	-1	62	-1	60	-1	-1
62	66	4	-1	63	-1	61	-1	-1
63	67	4	-1	64	-1	62	-1	-1
64	68	4	-1	65	-1	63	16	-1
65	69	4	-1	66	-1	64	-1	-1
66	70	4	-1	67	-1	65	-1	-1
67	71	4	-1	68	-1	66	-1	-1
68	72	4	-1	69	-1	67	17	-1
69	73	4	-1	70	-1	68	-1	-1
70	74	4	-1	71	-1	69	-1	-1
71	75	4	-1	72	-1	70	-1	-1
72	76	4	-1	73	-1	71	18	-1
73	77	4	-1	74	-1	72	-1	-1
74	78	4	-1	75	-1	73	-1	-1
75	79	4	-1	76	-1	74	-1	-1
76	80	4	-1	77	-1	75	19	-1
77	81	4	-1	78	-1	76	-1	-1
78	82	4	-1	79	-1	77	-1	-1
79	83	4	-1	80	-1	78	-1	-1
80	84	4	-1	81	-1	79	20	-1
81	85	4	-1	82	-1	80	-1	-1
82	86	4	-1	83	-1	81	-1	-1
83	87	4	-1	84	-1	82	-1	-1
84	88	4	-1	85	-1	83	21	-1
85	89	4	-1	86	-1	84	-1	-1
86	90	4	-1	87	-1	85	-1	-1
87	91	4	-1	88	-1	86	-1	-1
88	92	4	-1	89	-1	87	22	-1
89	93	4	-1	90	-1	88	-1	-1
90	94	4	-1	91	-1	89	-1	-1
91	95	4	-1	92	-1	90	-1	-1
92	96	4	-1	93	-1	91	23	-1
93	97	4	-1	94	-1	92	-1	-1
94	98	4	-1	95	-1	93	-1	-1
95	99	4	-1	96	-1	94	-1	-1
96	100	4	-1	97	-1	95	24	-1
97	101	4	-1	98	-1	96	-1	-1
98	102	4	-1	99	-1	97	-1	-1
99	103	4	-1	100	-1	98	-1	-1
100	104	4	-1	-1	221	99	25	-1
101	4	5	0	-1	102	-1	-1	-1
102	4	6	101	-1	103	-1	-1	-1
103	4	7	102	-1	104	-1	-1	-1
104	4	8	103	-1	105	-1	26	-1
105	4	9	104	-1	106	-1	-1	-1
106	4	10	105	-1	107	-1	-1	-1
107	4	11	106	-1	108	-1	-1	-1
108	4	12	107	-1	109	-1	27	-1
109	4	13	108	-1	110	-1	-1	-1
110	4	14	109	-1	111	-1	-1	-1
111	4	15	110	-1	112	-1	-1	-1
112	4	16	111	-1	113	-1	28	-1
113	4	17	112	-1	114	-1	-1	-1
114	4	18	113	-1	115	-1	-1	-1
115	4	19	114	-1	116	-1	-1	-1
116	4	20	115	-1	117	-1	29	-1
117	4	21	116	-1	118	-1	-1	-1
118	4	22	117	-1	119	-1	-1	-1
119	4	23	118	-1	120	-1	-1	-1
120	4	24	119	121	-1	-1	30	-1
121	5	24	-1	122	-1	120	-1	-1
122	6	24	-1	123	-1	121	-1	-1
123	7	24	-1	124	-1	122	-1	-1
124	8	24	-1	125	-1	123	31	-1
125	9	24	-1	126	-1	124	-1	-1
126	10	24	-1	127	-1	125	-1	-1
127	11	24	-1	128	-1	126	-1	-1
128	12	24	-1	129	-1	127	32	-1
129	13	24	-1	130	-1	128	-1	-1
130	14	24	-1	131	-1	129	-1	-1
131	15	24	-1	132	-1	130	-1	-1
132	16	24	-1	133	-1	131	33	-1
133	17	24	-1	134	-1	132	-1	-1
134	18	24	-1	135	-1	133	-1	-1
135	19	24	-1	136	-1	134	-1	-1
136	20	24	-1	137	-1	135	34	-1
137	21	24	-1	138	-1	136	-1	-1
138	22	24	-1	139	-1	137	-1	-1
139	23	24	-1	140	-1	138	-1	-1
140	24	24	-1	141	-1	139	35	-1
141	25	24	-1	142	-1	140	-1	-1
142	26	24	-1	143	-1	141	-1	-1
143	27	24	-1	144	-1	142	-1	-1
144	28	24	-1	145	-1	143	36	-1
145	29	24	-1	146	-1	144	-1	-1
146	30	24	-1	147	-1	145	-1	-1
147	31	24	-1	148	-1	146	-1	-1
148	32	24	-1	149	-1	147	37	-1
149	33	24	-1	150	-1	148	-1	-1
150	34	24	-1	151	-1	149	-1	-1
151	35	24	-1	152	-1	150	-1	-1
152	36	24	-1	153	-1	151	38	-1
153	37	24	-1	154	-1	152	-1	-1
154	38	24	-1	155	-1	153	-1	-1
155	39	24	-1	156	-1	154	-1	-1
156	40	24	-1	157	-1	155	39	-1
157	41	24	-1	158	-1	156	-1	-1
158	42	24	-1	159	-1	157	-1	-1
159	43	24	-1	160	-1	158	-1	-1
160	44	24	-1	161	-1	159	40	-1
161	45	24	-1	162	-1	160	-1	-1
162	46	24	-1	163	-1	161	-1	-1
163	47	24	-1	164	-1	162	-1	-1
164	48	24	-1	165	-1	163	41	-1
165	49	24	-1	166	-1	164	-1	-1
166	50	24	-1	167	-1	165	-1	-1
167	51	24	-1	168	-1	166	-1	-1
168	52	24	-1	169	-1	167	42	-1
169	53	24	-1	170	-1	168	-1	-1
170	54	24	258	171	-1	169	-1	-1
171	55	24	-1	172	-1	170	-1	-1
172	56	24	-1	173	-1	171	43	-1
173	57	24	-1	174	-1	172	-1	-1
174	58	24	-1	175	-1	173	-1	-1
175	59	24	-1	176	-1	174	-1	-1
176	60	24	-1	177	-1	175	44	-1
177	61	24	-1	178	-1	176	-1	-1
178	62	24	-1	179	-1	177	-1	-1
179	63	24	-1	180	-1	178	-1	-1
180	64	24	-1	181	-1	179	45	-1
181	65	24	-1	182	-1	180	-1	-1
182	66	24	-1	183	-1	181	-1	-1
183	67	24	-1	184	-1	182	-1	-1
184	68	24	-1	185	-1	183	46	-1
185	69	24	-1	186	-1	184	-1	-1
186	70	24	-1	187	-1	185	-1	-1
187	71	24	-1	188	-1	186	-1	-1
188	72	24	-1	189	-1	187	47	-1
189	73	24	-1	190	-1	188	-1	-1
190	74	24	-1	191	-1	189	-1	-1
191	75	24	-1	192	-1	190	-1	-1
192	76	24	-1	193	-1	191	48	-1
193	77	24	-1	194	-1	192	-1	-1
194	78	24	-1	195	-1	193	-1	-1
195	79	24	-1	196	-1	194	-1	-1
196	80	24	-1	197	-1	195	49	-1
197	81	24	-1	198	-1	196	-1	-1
198	82	24	-1	199	-1	197	-1	-1
199	83	24	-1	200	-1	198	-1	-1
200	84	24	-1	201	-1	199	50	-1
201	85	24	-1	202	-1	200	-1	-1
202	86	24	-1	203	-1	201	-1	-1
203	87	24	-1	204	-1	202	-1	-1
204	88	24	-1	205	-1	203	51	-1
205	89	24	-1	206	-1	204	-1	-1
206	90	24	-1	207	-1	205	-1	-1
207	91	24	-1	208	-1	206	-1	-1
208	92	24	-1	209	-1	207	52	-1
209	93	24	-1	210	-1	208	-1	-1
210	94	24	-1	211	-1	209	-1	-1
211	95	24	-1	212	-1	210	-1	-1
212	96	24	-1	213	-1	211	53	-1
213	97	24	-1	214	-1	212	-1	-1
214	98	24	-1	215	-1	213	-1	-1
215	99	24	-1	216	-1	214	-1	-1
216	100	24	-1	217	-1	215	54	-1
217	101	24	-1	218	-1	216	-1	-1
218	102	24	-1	219	-1	217	-1	-1
219	103	24	-1	220	-1	218	-1	-1
220	104	24	239	-1	-1	219	55	-1
221	104	5	100	-1	222	-1	-1	-1
222	104	6	221	-1	223	-1	-1	-1
223	104	7	222	-1	224	-1	-1	-1
224	104	8	223	-1	225	-1	56	-1
225	104	9	224	-1	226	-1	-1	-1
226	104	10	225	-1	227	-1	-1	-1
227	104	11	226	-1	228	-1	-1	-1
228	104	12	227	-1	229	-1	57	-1
229	104	13	228	-1	230	-1	-1	-1
230	104	14	229	-1	231	-1	-1	-1
231	104	15	230	-1	232	-1	-1	-1
232	104	16	231	-1	233	-1	58	-1
233	104	17	232	-1	234	-1	-1	-1
234	104	18	233	-1	235	-1	-1	-1
235	104	19	234	-1	236	-1	-1	-1
236	104	20	235	-1	237	-1	59	-1
237	104	21	236	-1	238	-1	-1	-1
238	104	22	237	-1	239	-1	-1	-1
239	104	23	238	-1	220	-1	-1	-1
240	54	5	50	-1	241	-1	60	-1
241	54	6	240	-1	242	-1	-1	-1
242	54	7	241	-1	243	-1	-1	-1
243	54	8	242	-1	244	-1	-1	-1
244	54	9	243	-1	245	-1	61	-1
245	54	10	244	-1	246	-1	-1	-1
246	54	11	245	-1	247	-1	-1	-1
247	54	12	246	-1	248	-1	-1	-1
248	54	13	247	-1	249	-1	62	-1
249	54	14	248	-1	250	-1	-1	-1
250	54	15	249	-1	251	-1	-1	0
251	54	16	250	-1	252	-1	-1	-1
252	54	17	251	-1	253	-1	63	-1
253	54	18	252	-1	254	-1	-1	-1
254	54	19	253	-1	255	-1	-1	-1
255	54	20	254	-1	256	-1	-1	-1
256	54	21	255	-1	257	-1	64	-1
257	54	22	256	-1	258	-1	-1	-1
258	54	23	257	-1	170	-1	-1	-1
259	50	50	-1	-1	-1	-1	-1	-1
